base
base
zayvehead.png These guys have great armor. I should take it.
prison
100
100
xxx

CwwwwwwwwwwwWwwwwwwwwwwwwwwc
WB N BWB   BW  g         g W
W     W     W              W
W     D     D    ttttttt   W
WB   BWB   BW              W
W     W     W  u           W
Wwwwwwewwwwwewwwwwww wwwwwwW
W                          W
W   aa                     W
W    b                     Wwwwwwwwwwwwwwewwwwwwwwwwwwwwwwwwwc
W                          W             W                  BW
W                          W             D                   W
W                          W             W        u          W
Xwwwwwc   Cwwwwwwwwwwwwwwwwx    u M u    Wwwwwwwwww  wwwwwwwwW
      W   W            u  ¢W     bMb     W         bb        W         
      W   W            t g W      M      W                   W         
      W   Wwwwwwww wwwwwwwwx             W      u     u      W         
      W   D                              W                   W         
      W   W                              W        bbb        W         
      W   W             www              W  bb               W         
Wwwwwwewwwewwwwwwwwwwww1   wwwwwwwwwwwwwwx          M        W
W                                                   M        W
W  bb         M  bbb                       bb       M        W
W            bM  u            M    u                         W
W        b         b          M                    bbb       W
W            M            b   Mbb         M                  W
W            M                            M                  W
Xwwwwc Cwwwwwwwwwwwwwwwwwwwwwwwwwwwwwwwwwwwwwwwwwwwwwwwwwwwwwx
     W W
Cwwwwx Xwwwwc
W           W
W           W
W           W
W           W
W     n     W
Xwwwwwpwwwwwx


