prison
base
zayvehead.png better clear this hangar
secretbaseoffice
525
200
resistancebase
50
100
xxx

Cwwwwwwwwwwwwwwwwwwwwwc             FfffffffffffffffffffffffffffffffffffffffffffffffffffffF
P                     W             F                                                     F
W                     W             F                                                     F
W A      z            WfGfffffffffffF                                                     F
W                     W                                                       uz          F
W                     W                                                                   F
W                     W                                                        uuu        F
W                     W                          u uz        u                            F
W                     W                            u                                      F
W        z            W                               u                                   F
W                     W               u                                                   F
W                     W                                                                   F
W                     W                                                    u              F
W                     W              uz                                                   F
W                     W                                                uu  z              F
W        z            W                  u                              u                 F
W                     W               u                                   u               F
W                     W                                                                   F
W                     D                                                                   F
W                     W                        u   u                                      F
W                     W                          u u z                                    F
W        z            W                             u                                     F
W                     W                                  u                                F
W                     W                                                                   F
W                     W                                                                   F
XwwwwwwwwwwwwwwwwwwwwwxfffffffffffffffffffffffffffffffffffffffffffffffffffffffffffffffffffF
