
CwwwwwwwwwwwWwwwwwwwwwwwwwwc
WB N BWB   BW  g         g W
W     W     W              W
W     D     D    ttttttt   W
WB   BWB   BW              W
W     W     W  1           W
Wwwwwwewwwwwewwwwwww wwwwwwW
W                          W
W   aa                     W
W    b                     Wwwwwwwwwwwwwwewwwwwwwwwwwwwwwwwwwc
W                          W             W                  BW
W                          W             D                   W
W                          W             W        1          W
Xwwwwwc   Cwwwwwwwwwwwwwwwwx    1 M 1    Wwwwwwwwww  wwwwwwwwW
      W   W            1  ¢W     bMb     W         bb        W         
      W   W            t g W      M      W                   W         
      W   Wwwwwwww wwwwwwwwx             W      0     0      W         
      W   D                              W                   W         
      W   W                              W        bbb        W         
      W   W             www              W  bb               W         
Wwwwwwewwwewwwwwwwwwwww1   wwwwwwwwwwwwwwx          M        W
W                                                   M        W
W  bb         M  bbb                       bb       M        W
W            bM  0            M    0                         W
W        b         b          M                    bbb       W
W            M            b   Mbb         M                  W
W            M                            M                  W
Xwwwwc Cwwwwwwwwwwwwwwwwwwwwwwwwwwwwwwwwwwwwwwwwwwwwwwwwwwwwwx
     W W
Cwwwwx Xwwwwc
W           W
W           W
W           W
W           W
W     n     W
Xwwwwwpwwwwwx


