
Cwwwwwwwwwwwwwwwwwwwwwc             FfffffffffffffffffffffffffffffffffffffffffffffffffffffF
P                     W             F                                                     F
W                     W             F                                                     F
W A      z            WfGfffffffffffF                                                     F
W                     W                                                       0z          F
W                     W                                                                   F
W                     W                                                        110        F
W                     W                          1 0z        1                            F
W                     W                            1                                      F
W        z            W                               0                                   F
W                     W               1                                                   F
W                     W                                                                   F
W                     W                                                    1              F
W                     W              0z                                                   F
W                     W                                                00  z              F
W        z            W                  0                              1                 F
W                     W               1                                   0               F
W                     W                                                                   F
W                     D                                                                   F
W                     W                        0   1                                      F
W                     W                          1 0 z                                    F
W        z            W                             1                                     F
W                     W                                  0                                F
W                     W                                                                   F
W                     W                                                                   F
XwwwwwwwwwwwwwwwwwwwwwxfffffffffffffffffffffffffffffffffffffffffffffffffffffffffffffffffffF
