prison
prison
zayvehead.png better clear this hangar
prison
600
700
cannon1
100
150
xxx

CwwwwwwwwPwwwwwwwwwwwwc
W                     W
W       b             W
W       bz            W
W                     W
W 1                   W
W                     W
W                     W
W                     W
W        z            W
W                     W
W                     W
W                     W
W                     W
W                     W
W        z            W
W                     W
W   bb           1    W
W                     W
W                     W
W                     W
W        z            W
W                     W
W                     W
W     1               W
W                b    W
W                     W
W        z            W
W                     W
W                     W
W    1                W
W                     W
W                     W
W        z            W
W                     W
W        NG           W
W                     W
Xwwwwwwwwwwwwwwwwwwwwwx
