
FfffffffffF
F      1  F
F      G  F
P      1  F
F         F
F N       F
FfffffffffF