
CwwPwwWwwwwwWwwWwwwwwWwwwwwc
W     WB   BW2 WB   BWB   BW
W     W     W  W     W     W
W     W     D  D     W     W
W     WB   BW  WB   BWB   BW
W     W  0  W  W   0 W     W
Wwwkwwewwwwwx  Xwwwwweww wwWwwwwwwwwwwwwwwwc
W     1          tttttt   2W   :   :   :   W
W                   1      W               W
W                          D               W
W             1            D   :   :   :   W
W                   0      W               W
W2                         W      0        W
W                         2Cwwwwwwwwwwwwwwwx             
XwwwwwwwwwwcPCwwwwwwwwwwwwwx             
           W W
           W W
           W W
           W W
