base
base
zayvehead.png Well, looks like I'm back at it
secretbaseoutside
650
200
secretbaseoffice
50
100
xxx

Cwwwwwwwwwwwc
WP          Xwwwwwwwwwwwwwwwwwwwwwwwwwwwc
W k                      M              W
W           Cwwwww  wwwwwewwwww  wwwwwc W
W t        tW      0     W            W W
Wwww1   wWwwW        t   D            D W
W        D  W  t         W      ttt   W W
W        W  W            W            W W        
W        W  WwwwwwwwwwwwwewwwwwwwwwwwwW W
W        D  W            W            W W
W        W  D  1         W            W W
W        W  W       t   MD    1  tt   D W
W 1      W  W            W            W W
W wwwwwwwxbbXwwwww  wwwwwewwwww  wwwwwxbW
W           M            M              W
Xww wwwwwwwwewwwww  wwwwwewwwww  wwwwwcbW
W         ¢ W            W            W W
Www wwwwwWwwW            D            D W
W        D  W         tttW        0   W W
W        W  W            W            W W        
W   0    W  WwwwwwwwwwwwwewwwwwwwwwwwwW W
W        D  W            W            W W
W        W  D  1         W        tt  W W
W        W  W       t    D    1       D W
W        W  W            W            W W
WbwwwwwwwWbbXwwwwwbwwwwwwewwwwww wwwwwx W
W                                       W
Xwc wwwwwwwwwwwwwwwwwwwwwwwwwwwwwwwwwwwwW
  W                                     W
CwXwwwcbbbCwwwwwwwwwwwwwwwwwwwwwc   Cwwwx
W     W   W   0      M     M    W   W
W     W   W          M  1  M    W   W
W     D   D          M     M    D   W
W     W   Wbbbbb     M          W   W
W     W   W                     W   W
XwwPwwXwwwewwwwwwwwwwwwwwwwwwwwwewwwx	  